1111111111111111111111111111111111111111111111
111111111111000C000000000000000000000EP1111111
111111111111000C000000000000000000000E01111111
111111111111000C000000000000000000000E01111111
111111111111000C000000000000000000000E01111111
1111111111111111111111111111111111111111111111
1111111111111111111111111111111111111111111111
1111111111111111111111111111111111111111111111
1111111111111111111111111111111111111111111111
1111111111111111111111111111111111111111111111
1111111111111111111111111111111111111111111111
